36,7,6,,,,
,c2,c3,c4,c2,c3,c6
,c1,c6,c2,c2,c1,c1
,c5,c4,c2,c3,c4,c5
,c6,c5,c4,c5,c6,c4
,c3,c3,c3,c4,c5,c2
,c4,c2,c6,c1,c3,c6
,c4,c1,c1,c5,c2,c3
,Right,Right,Right,Right,Right,Right