49,7,6,,,,
,c1,c3,c5,c1,c4,c2
,c2,c4,c3,c1,c6,c6
,c2,c3,c4,c5,c5,c2
,c4,c4,c6,c4,c2,c3
,c5,c3,c2,c1,c5,c1
,c6,c2,c6,c4,c4,c5
,c1,c1,c3,c2,c1,c6
,Down,Down,Down,Down,Down,Down