42,7,6,,,,
,c2,c3,c6,c6,c5,c3
,c6,c2,c1,c3,c4,c4
,c6,c1,c3,c5,c3,c2
,c1,c4,c6,c1,c2,c2
,c3,c5,c3,c2,c1,c6
,c1,c1,c2,c6,c6,c5
,c5,c4,c3,c1,c2,c5
,Down,Down,Down,Down,Down,Down