33,7,6,,,,
,c2,c3,c4,c4,c5,c5
,c1,c6,c1,c6,c1,c6
,c3,c3,c2,c6,c4,c5
,c2,c2,c5,c2,c5,c4
,c4,c4,c3,c4,c3,c3
,c6,c3,c1,c6,c4,c2
,c5,c4,c3,c4,c1,c1
,Right,Right,Right,Right,Right,Right