38,7,6,,,,
,c5,c4,c3,c2,c1,c6
,c1,c1,c4,c2,c6,c4
,c2,c2,c6,c3,c3,c2
,c1,c3,c5,c4,c1,c3
,c4,c4,c1,c6,c1,c5
,c3,c5,c2,c2,c5,c4
,c6,c2,c6,c1,c5,c4
,Right,Right,Right,Right,Right,Right