76,8,7,,,,,,
,c2,c3,c4,c2,c1,c1,c6,Left
,c5,c2,c6,c5,c5,c4,c2,Left
,c4,c3,c1,c3,c6,c3,c1,Left
,c3,c4,c1,c4,c6,c2,c6,Left
,c1,c2-b-7,c6,c5,c5,c2,c5,Left
,c2,c6,c3,c2,c4,c4,c4,Left
,c4,c5,c4,c5,c3,c1,c5,Left
,c6,c2,c3,c1,c2,c5,c2,Left