15,5,4,,
,c3,c2,c1,c4
,c1,c4,c1,c3
,c2,c3,c4,c2
,c2,c2,c3,c1
,c4,c3,c2,c3