70,8,7,,,,,,
,c1,c3,c5,c6,c1,c6,c2,Left
,c3,c2,c4,c1,c2,c3,c4,Left
,c4,c2,c4,c5,c6,c3,c1,Left
,c6,c3,c4,c5,c1,c6,c4,Left
,c2,c3,c5,c4,c6,c2,c5,Left
,c2,c5,c4,c3,c4,c5,c1,Left
,c3,c4,c2,c6,c3,c2,c1,Left
,c4,c5-b-5,c3,c1,c2,c4,c6,Left