,73,8,7,,,,,
,,c2,c1,c2,c3,c4,c3,c6
,,c4,c6,c1,c6,c3,c5-b-5,c4
,,c5,c6,c5,c2,c3,c2,c5
,,c4,c4,c4,c3,c4,c4,c3
,,c3,c5,c4,c1,c5,c6,c4
,,c1,c6,c2,c2,c1,c3,c2
,,c6,c3,c4,c5,c1,c2,c1
,,c2,c1,c2,c6,c5,c4,c3
,,Up,Up,Up,Up,Up,Up,Up