81,8,8,,,,,,,
,c5,c3,c4,c2,c6,c7-b-7,c1,c2,Left
,c7,c2,c1,c6,c1,c2,c6,c3,Left
,c4,c3,c7,c1,c3,c2,c3,c5,Left
,c6,c1,c4,c3,c7,c5,c5,c5,Left
,c4,c4,c3,c5,c4,c4,c6,c6,Left
,c3,c2,c4,c2,c6,c5,c3,c1,Left
,c2,c3,c4,c4,c1,c2,c5,c2,Left
,c1,c1,c3,c1,c7,c3,c7,c6,Left