53,7,6,,,,
,c4,c5,c6,c2,c4,c1
,c6,c2,c4,c6,c5,c3
,c2,c4,c1,c4,c5,c4
,c3,c2,c6,c3,c2,c5
,c5,c2,c6,c5,c5,c3
,c5,c3,c3,c1,c6,c4
,c4,c3,c2,c1,c3,c2
,Up,Up,Up,Up,Up,Up