84,7,6,,,,
,c9,c3,c9,c7,c2,c3
,c2,c3,c9,c7,c9,c5
,c5,c6,c6,c2,c6,c3
,c7,c2,c1,c7,c9,c5
,c6,c5,c4,c2,c2,c3
,c6,c3,c5,c2,c3-b-5,c2
,c3,c7,c5,c6,c9,c7
,Up,Up,Up,Up,Up,Up