80,8,8,,,,,,
,c2,c3,c5,c6,c1,c5,c6,c1
,c6,c2,c1,c2,c6,c3,c4,c7
,c7,c4,c4,c2,c1,c7,c6,c6
,c3,c3,c6,c4,c3,c7,c5,c5
,c1,c4,c7-b-7,c3,c5,c3,c4,c3
,c2,c2,c1,c6,c4,c2,c2,c2
,c4,c2,c5,c3,c4,c1,c4,c3
,c7,c3,c4,c5,c6,c5,c6,c1
,Down,Down,Down,Down,Down,Down,Down,Down